111111111111111111111111111111111111111111111111111111111111111
100000000000100000000000000000000000000000000000000000000000001
100000@00000100000000000000000000000000000000000000000000000001
100000000000100000000000000000000000000000000000000001000000001
100000000000100000000000000000000000000000000000000001000000001
111110001111100000000000000000000000000000000000000001000000001
100000000000100000000000000000000000000000000000000001000000001
100000000000100000000000000000000000000000000000000001000000001
100000000000100000000000000000000000000000000000000001000000001
100000000000000000000000000000000000000000000000000001000000001
100000000000000002000000000000000000000000000000000001000000001
100000000000000000000000000000000000000000000000000001000000001
100000000000000000000000000000000000000000000000000001000000001
100000000000000000000000000000000000000000000111111111111111111
100000000000000000000000000000000000000000000000000000000000001
100000000000000000000000000000020000000000000000000000000000001
100000000000000000000000000000000000000000000000000000000000001
100000000000000000000000000000000000000000000000000000000000001
100000000000000000000000000000000000000000000000000000000000001
100000000000000000000000000000000000000000000000000000000000001
100000000000000000000000000000000000000000000000000000000000001
100000000100000000000000000000000000000001000000000000000000001
100000000000000000000000000000000000000000000000000000000000001
100000000000000000000000000000000000000000000000000000000000001
100000000000000000000000000000000000000000000000000000000000001
100000000000000000000000000000000000000000000000000000000000001
100000000000000000000000000000000000000000000000000000000000001
100000000000000000000000000000000000000000000000000000000000001
100000000000000000000000000000000000000000000000000000000000001
100000000000000000002000000000000000000000000020000000000000001
100000000000000000000000000000000000000000000000000000000000001
100000000000000000000000000000000000000000000000000000000000001
100000000000000000000000000000000000000001000000000000000000001
100000000000000000000000000000000000000000000000000000000000001
100000000000000000000000000000000000000000000000000000000000001
111111111111111111111111111111111111111111111111111111111111111