111111111111111111111111111111111111111111111111111111111111111
100000000000100000000000000000000000000000000000000000000000001
100000@00000100000000000000000000000000000000000000000000000001
100000000000100000000000000000000000000000000000000001000000001
100000000000111111111111111111111111111100000000000001000000001
111110001111100000000000000000000000000000000000000001000000001
100000000000100000000000000000000000000000000000000001000000001
100000000000100000000000000000000000000000000000000001000000001
100000000000100000000000000000000000000000000000000001000000001
100000000000000000000000000000000000000000000000000001000000001
100000000000000002000000000000000000000000000000000001000000001
100000000000000000000010000000000000000000000000000001000000001
100000000000000000000010000000000000000000000000000001000000001
100000000000000000000010222000000000000000000111111111111111111
100000000000000000000010000000000000000000000100000000000000001
100000000000000000000010000000020000000000000100000000000000001
100000000000200002000011111110000000000000000100000000000000001
100000000000000000000010000000000000000000000100000000000000001
100000000000000000000010000000000000000000000100000000000000001
100000000000000000000010000000000000000000000100000000000000001
100000000000000000000010000000000000000000000100000000000000001
100000000100000000000000000000000000000001000100000000000000001
100000000000000000000000000000000000000000000100000000000000001
100000000000000000000000000000000000000000000100000000000000001
100000000000000000000000000000000000000000000100000000000000001
100000000111111111111111111111111110000000000100000000000000001
100000000000000000000000000000000000000000000100000000000000001
100000000000000000000000000000000000000000000100000000000000001
100000000000000000000000000000000000000000000000000000000000001
100000000000000000002000000000000000000000000020000000000000001
100000000000000000000000000000000000000000000000000000000000001
100000000000000000000000000000000000000000000000000000000000001
100000000000000000000000000000000000000001000000000000000000001
100000000000000000000022111020000000000000000000000000000000001
100000000000000000000000000000000000000000000000000000000000001
111111111111111111111111111111111111111111111111111111111111111